여자	남자
여성	남성
어머니	아버지
이모	삼촌
아주머니	아저씨
소녀	소년
여학생	남학생
외숙모	외삼촌
숙모	삼촌
큰어머니	큰아버지
고모부	고모
아내	남편
할머니	할아버지
엄마	아빠
음핵	음경
공주	왕자
홀어미	홀아비
어미	아비
신부	신랑
대모	대부
모계	부계
계모	계부
미녀	미남
손녀	손자
모성	부성
딸	아들
처녀	총각
레즈비언	게이
난자	정자
질	음경
수녀	수도사
여자친구	남자친구